1111111111111111111111111111111111
1000000000000000000000000000000001
1010010100100C0E111001000000010101
1111111111111111111001000000010101
10000000000000000P0000000000000011
1111111111111111111111111111111111